хороших экспертов очень мало, в основном они выбирают, где будут работать
внутренняя мотивация - то что движет человека изнутри
внешняя мотивация - внешние факторы, двигающие человека
если они скорелированны, то человек замотивирован
если нет, то человек скорее всего уйдет

наша цель - понять, как цели человека связаны с интересами компаниями
этим обычно занимаются руководитель и руководитель проекта

потребность - больше денег
поведение - наши действия, чтобы тот, кого мы хотим замотивировать, удовлетворил потребность
вознаграждение - премии

если удовлетоврить потребность сразу, то он не будет работать (зачем?)
вознаграждение обязательно должно быть (если что он что-то сделал, за что обещали премию, то надо ее дать )

потребность в безопасности и защите - если офис расположен на краю "быдлорайона", то никакие деньги их не удержат

административная политика компании - стиль управления, некоторых правил общения между сотрудниками, начальник-подчиненный, организация офиса

условия труда - график работы, ежемесячные оплаты, дополнительные страховки, чай/кофе (что я имею кроме зарплаты?)

достижения - связаны с чем-то рабочим, что я считаю значимым для себя (я решил какую-то сложную задачу и мне приятно от того что я этого сам добился)

награждение - самый дешевый способ мотивировать сотрудников
горизонтальный рост -> junior, senior, 
вертикальный рост -> младший менеджер, старший менеджер

партисипативный менеджмент - технология с рядом меропириятий, чтобы дать некоторым небольшим сотрудникам дать руководящие обязанности
добавляем некоторой ответственности в локальной зоне (возможно связана не с расширением, а с привлечением дополнительной отвественности на локальные пункты)
надо быть аккуратным, потому что не всегда люди умеют работать с данной им властью

автономные рабочие группы - выделяем группы, чтобы они автономно решали свои задачи (каждый ответственен за свою часть, можно устраивать что-то типа минисоревнований между группами)

расширение должностных обязанностей и ответственностей - почти партисипативный менеджмент, только мы расширяем обязанности, то есть тебе могут вменяться дополнительные обязанности за дополнительные плюшки (например, можно попросить делать codereview в другом проекте)

ротация - раз в какое-то время переводят в другую область, чтобы не было скучно (например, с frontend на backend) не обязательно с изменением зарплаты или обязанностей
например нужна чтобы не вступали в сговор (например менять их местами, чтобы не сложилось хорошего устоявшегося коллектива (чтобы предотвратить взятки)) или когда много рутинных задач

гибкий график не всегда хорош (чтобы люди синхронизировались и вообще общались)
например, с 12 до 5 быть в офисе

переодические профессиональные перемещения - можно поменять на чуть-чуть бухгалтера и юриста на чуть-чуть (на практике почти не применяется)

совмещение смежных профессий - профессии на стыке технологий/наук и т.д. (оч круто мотивирует)

внутреннее совместительство - работа одного человека на нескольких рабочих местах в рамках одной профессии (аналитики могут сидеть целый день у заказчика)
надо быть аккуратным - аналитика не отпускает жена и если отправлять его на неделю в спб каждый месяц, то ничего крутого не получится

компенсационнные методы - работодатель придумывает что-то, что отвлекает на чуть-чуть от работы (совместный поход на обед, пицца по пятницам)

история Ставка + X + Y: сначала все начали быстро впахивать, но быстро начали отсеиваться (но при этом оставались на уровне нужном руководителю)

информация о достижениях - раз в несоклько месяцев (не очень часто) рассказывать, чего добилась компания и как в этом помогли сотрудники

совместные мероприятия - развращает людей (слишком много неформальных связей, начинают больше обсуждать свои темы)

обучение - обычно, если человеку что-то надо, то он и сам это сможет
эффективно, если работодателю это нужно больше, чем сотруднику



